11111
1E111
11C11
1P111
11111
