11111111111111
1P00111CCCCCC1
1000000C000001
100E0000000111
10000110001C01
1000C000001C01
11111111111111
