11111111111111
1P001110000001
1000000C000001
100E0000000001
10000110001001
1000C000001C01
11111111111111
