11111111111111
00000000000001
1000P00C000001
100E0000000001
10000000000001
1000C000000C01
11111111111111
